..........
.s.f......
psb..b....
.s........
.....uu...
......u...
..........
..........
..........
..........
..........
..........
..........
..........
..........